1111111111111111111111
10000000000000000000E1
101X00000000X0000000X1
101X0000X000X0000000X1
101X000000C000000000X1
101X000000C000000000X1
1P1X000000C000000000X1
1111111111111111111111
