111111111111111111111
100000010000001100001
100000100000010010001
100001010000000100001
100001111000001000001
1000X0010C00011110001
1P0000000C00000000E01
111111111111111111111
