11111111111111111111
111X0000000C11111111
1000000P00000X0000E1
11111111111111111111
