11111111111
1E000000001
1P000000001
1C00000000A
11111111111
