11111111111
1E00000000A
1P000000001
1C000000001
11111111111
