11111111111
1E000000001
1P000000001
1C0000000A1
11111111111
