11111111111
AE000000001
1P000000001
1C000000001
11111111111
