11111111111
1E000000001
1P000000001
1C000000001
1111111111A
