111111A1111
1E000AA0001
1P0000A0001
1C0000A0001
111111A1111
