111111111111111
1EC000000000001
100000000000001
100000000000001
111111111111111
