101111111111111
1E0000000000001
1P0000000000001
1C0000000000001
100000000000001
111111111111111
