111111111111111
1E0000000000001
10PP00000000001
10C000000000001
111111111111111
