11111111111
1E000000001
1P00000000A
1C000000001
11111111111
