11111111111
1E000000001
1P0000A0001
1C000000001
11111111111
