1111111111111111111111
10PE1000000000C0000001
100010C010000111100001
10001000100C0000000001
10001000100000C0011001
1C001C0010000100000001
100000001000001000C001
1111111111111111111111
