11111111
100P0X01
10C0E001
11111111
