111111111111111111111111111111111
10E0000000000000000000000C0000001
10000000000000000000000C000000001
10000000000X000000000C0X000000001
10000000000X00000C00000X000000001
10000000000X0000000C000X000000001
1P000000000X00000000C00X000000001
111111111111111111111111111111111
