111111111111111
1CCCCCCCCCCCCC1
1CCCCCCCCCCCCC1
1PECCCCCCCCCCC1
111111111111111
