1111111
1PEC01
1000001
1111111
