
1111111111111
10000EPC00001
1111111111111
