1111111
1PEC001
10000011
1000001
1111111
