1111111
1PEC001
100000011
1111111
