1111111
1PEC001
100011
1111111
