1111111
1PEC001
100001
1000001
1111111
