111111
1PEC001
1000001
1111111
