1111111
1PEC0001
1000001
1111111
