1111111
1PEC001
1000001
11111111
