11111111111
100PEC11111
11111111111

