111111111
1E0001C01
100000111
1C00000P1
111111111
