111111111
1E1000001
110000001
1C00000P1
111111111
