111111111
10CEP0001
111111111
