111111111
1E0000001
110000001
1C10000P1
111111111
