111111111
10PEC0001
111111111
