111111111
100E10001
111111001
1C00000P1
111111111
