111111111
1E0000001
111111111
1C00000P1
111111111
