111111111
1E0000001
100000011
1C00001P1
111111111
