111111111
1E1000001
101000001
1C10000P1
111111111
